_888_000_888_
_666_111_666_
_555_222_555_
_444_333_444_
_333_444_333_
_222_555_222_
_111_666_111_
_000_888_000_
