0___________
01__________
012_________
0123________
01234_______
012345______
0123456_____
01234567____
012345670___
0123456701__
01234567012_
012345670123
888888888888