9999999999999
_____________
_22222_22222_
_____________
333_99999_333
______9______
_44444944444_
______9______
999___9___999
______9______
_55555955555_
______9______
00_9999999_00